1111111111111111
1P.............1
1..............1
1..............1
1..............1
1..............1
1..............1
1111111111111111
