111111111111111111
1P..............X1
1................1
1................1
1................1
1................1
1................1
1................1
1................1
1................1
111111111111111111

