111111111111111111
1P...L...........1
1....L............1
1...........A....1
1......,.........1
1.....W.W.W......1
1.....W...A......1
1.....W..........1
1..............X.1
1................1
111111111111111111
