111111111111111111
1P..............A1
1................1
1................1
1................1
1................1
1................1
1................1
1A..............X1
1................1
111111111111111111
