,,,,,,,,,W,,,,,,,,
,,,,,,,,,W,,,,,,,,
,PA..,,,,W,,,,,,,,
,,,,A,,,,W,,,,,,,,
,,,,.,,,,W,,,,,,,,
,,,,.,,WWW,,,,,,,,
,,,,.,,W,,,,,,,,,,
,,,,L,AW.....X,,,,
,,,,...W,,,,,,,,,,
,,,,,,,W,,,,,,,,,,
,,,,,,,W,,,,,,,,,,

