,,,,,,,,,W,,,,,,,,
,,,,,,,,,W,,,,,,,,
,,,,,,,,,W,,,,,,,,
,,,P,..,,W,,,,,,,,
,,,.,,,.AW,,,,,,,,
,,,A,,A..W....,,,,
,,,.,,..AW.,,LX,,,
,A...,...W.,,,,,,,
,,,,.,.,,W,,,,,,,,
,,,,...,AW,,,,,,,,
,,,,,,,,,W,,,,,,,,

