,,,,,,,,,,W,,,,,,,
,,,.....PWW..,,,,,
,,....WWWW.....,,,
,.....W..,,,,,,,,,
,.....W..,.....,,,
,.....W..,.,,,.,,,
,.....W.....X,.,,,
,..AAAW..,.,,,.,,,
,..ALAW..,.....,,,
,,.AAAW..,,,,,,,,,
,,,,,,,,,,,,,,,,,,
