11WWA,,,,,,,,W,,,,
1,AWW,,,,,,,,W,A,,
1A1AWWWWW,,1,W,,,A
WWWAA,AAW,1AWW,,,,
,,WWWA11W111W,,..,
,P..WA1AWRR,W....,
,..LWAA,WAAAW....,
,...WAAAWAAAW..X.,
,..LWA,AWAWWW....,
,,..W,,,WWW..,..,,
,,,LW..A.....,.,,,

