111111111111111111
1P...............1
1....,...........1
1...........A....1
1.......A........1
1................1
1......L.........1
1................1
1.............X..1
1................1
111111111111111111
