111111111111111111
1111111.P,,,,,,,,1
1111111.W,,,,,,,,1
1111111.W,,,,,,,,1
111W111.W,,,,,,,,1
1111111.W,,,,,,,,1
1111111.W,,,,,,,,1
1111,AAAW,,,,,,,,1
11111ALAW....X...1
11111AAAW........1
111111111111111111
