111111111111111111
1P..W............1
1....W...........1
1....W...........1
1....W...........1
1....W...........1
1....W.......L...1
1....W...........1
1..............X.1
1................1
111111111111111111
