111111111111111111
1P...,....W......1
1......W...A.....1
1......W........1
1...L..W........1
1........,......1
1................1
1.........A....X.1
1................1
1................1
111111111111111111
