,,,,......,,,W,,,,
,,,........,,W,,,,
WWWWWW,,WWW.,W,,,,
,,,..W,,W.W..W,,,,
,,,..W,,W.W..W..,,
,,..,W,1W1W..WWW.,
,,..LW..WAW....W.L
,...,W1.W1W,..XW.,
,....W,,W1WWWWWW,,
,P,,.W,,W,,,,,,,,,
,,,,,WWWW,,,,,,,,,
