,,,,,,,.,W,.......
,,,,,,,.,W,...X...
,,,,....,W,.......
,,,,.,,,,W,,....A.
,,,,.,,,,W.,,....,
,........W..A.,..,
,........W..1,,AL,
,..P....AW,L.A,..,
,.....LA.W,..,A,L,
,,.....,,W,,A,,A.,
,,,,,,,,,W,,,,,,,,
