111111111111111111
1P...............1
1...........L....1
1.....,..........1
1.....W..........1
1......W.....A...1
1......W........X1
1.........W......1
1..........,.....1
1...............L1
111111111111111111
