,,,.,W.W,.,,,.....
,,,.,W.W,.,.,.....
,,..,W.W,.,.,111,A
,...,W.W,...1AAA,,
,...,W.W,....AXA,.
,...,W W,....AAA..
,...,W.W,.,.......
,.P.,W.W,.,,......
,..,,W.WW.,A..AAAA
1A,,,W.,W.A,,..ALA
LA,,,W.,W,,,,,.AAA
