,,,,,,,,,W,,,,,,,,
,,,,,,,,,W,,,,,,,,
APA..,,,,W,,,,,,,,
,,,,A,,,,W,,,,,,,,
,,,,.,,,,W,,,,,,,,
,,,,.,,WWW,,,,,,,,
,,,,.,,W,,,,,,,,,,
,,,,L,AW.....X,,,,
...,...W,,,,,,,,,,
.S.,,,,W,,,,,,,,,,
...,,,,W,,,,,,,,,,

